########################################
#......................................#
#......................................#
#......................................#
#......................................#
#......................................#
##################.....................#
#......................................#
#......................................#
#......................................#
#......................................#
#......................................#
#......................................#
#.........##############################
#......................................#
#......................................#
#......................................#
#......................................#
#......................................#
#......................................#
#########################..............#
#......................................#
#......................................#
#......................................#
#......................................#
#......................................#
#......................................#
#......................................#
#......................................#
#..........#############################
#......................................#
#......................................#
#......................................#
#......................................#
#......................................#
#......................................#
#......................................#
#......................................#
#......................................#
########################################