........................................
........................................
........................................
........................................
........................................
........................................
........................................
........................................
........................................
........................................
........................................
......########......##....##############
......##............##..........##......
......##............##..........##......
......##............##..........##......
......##............##..........##......
......##............##..........##......
......########......##..........##......
......##............##..........##......
......##............##..........##......
......##............##..........##......
......##............##..........##......
......##............##..........##......
......##............##..........##......
......##............##..........##......
........................................
........................................
........................................
........................................
........................................
........................................
........................................
........................................
........................................
........................................
........................................
........................................
........................................
........................................
........................................